 ################### 
 #........#........# 
 #.##.###.#.###.##.# 
 #.................# 
 #.##.#.#####.#.##.# 
 #....#...#...#....# 
 ####.###.#.###.#### 
    #.#...1...#.#    
#####.#.##-##.#.#####
     ...#423#...     
#####.#.#####.#.#####
    #.#.......#.#    
 ####.#.#####.#.#### 
 #........#........# 
 #.##.###.#.###.##.# 
 #..#.....P.....#..# 
 ##.#.#.#####.#.#.## 
 #....#...#...#....# 
 #.######.#.######.# 
 #.................# 
 ################### 